------0000000--
0000--000--00--
000000000--0000
0S00-------00T0
0000-------0000
------------000