------0000--000
0000--00O0--0T0
00X0--0000--000
0000--0000--000
0S00AA0000BB000
0000--0000-----
