--------0000---
--------0000---
000-----0--0000
0S0000000---0T0
000----00O--000
000----000--000
-00B---0-------
--000000-------