-----------0000
-0000CC0X0000S0
-0000-------000
-00G0----------
-0000----------
---000F000000--
----------0000E
000-------00000
0T000KK000000--
0000-----------