---HHHHHHH----
---HHHHHHH----
0000-----000--
000-------00--
000-------00--
0S0--0000HHHHH
000--0000HHHHH
-----0T0--HH0H
-----000--HHHH